--####f--####-#--##--###--##-
----####---#---###----s##----
#-----##---#####-------######
#####----############--------
--------################-----
-----###################-#---
--###############----###-##--
#------##########-##-------##
##---------######-#####------
#####----######-----######---
#####------######--------####
#########---------###########