#s########
#------###
#-####-###
#-###--###
#-###-####
#--#--####
####-#---#
####---#-#
########-#
########f#
