#####-------####----####---------##-----##--
###########--------------#########------##--
---------------##############---------------
##-----------------####################-----
############----------####################--
####---------------------------###----------
-----###########----##-----------####---####
-------s--###############--------###----####
-----###########------------################
-------###################-----###-----#####
--###--###---------------##---------######--
------------############-----############---
####-------------#######-----###############
---------------###########--######----##----
---------##########-------------------######
-----###################----------------####
----#################---------#######----f##
---###############--------########------###-
---################-----------------########
-----------#########-----------#############
-#######---------------#####################
--------------###############-------------##