##--#-#-###--f#-#-
##-####------#####
##--------#####--#
#####-----#-----s-
#------######-----
###-#######---####
#------#####-#####
######-------#####