-----#----#
#s--###----
###-----###
###------##
#----###--#
###-##-f###
##-----####